Є	Ye
І	I
А	A
Б	B
В	V
Ж	Zh
К	K
М	M
Н	N
О	O
П	P
Р	R
С	S
Т	T
Ч	Ch
Ю	Yu
Я	Ya
а	a
б	b
в	v
г	g
д	d
е	a
ж	zh
з	z
и	i
й	y
к	k
л	l
м	m
н	n
о	o
п	p
р	r
с	s
т	t
у	u
ф	f
х	h
ц	c
ч	ch
ш	sh
щ	sch
ы	y
ь	'
ю	yu
я	ya
є	ye
і	i
ї	yi
ѣ	i
ґ	g
